-1
#####
#Aa.@#
#B.b@#
#...#
#####